WWWWWWWWWWWWWWWWWWWWWWWWWWWWWWWWWWWWWWWWWWWWWWWWWWWWWWWWWWWW
W                                                          W
W                                                          W
W          E                                               W
W                                                          W
W                                                          W
W                                                          W
W                 DDDDDDDDDDDDDDDDDDDDDDDDDDDD             W
W                                                          W
W                                                          W
W                                                          W
W                                                          W
W                       B  K  B                            W
W                                                          W
W                                                          W
W                       K  B  K                            W
W                             J                            W
W                                                          W
W                                                          W
W                                                          W
W                                                          W
W                                                          W
W                                                          W
W                                                          W
WWWWWWWWWWWWWWWWWWWWWWWWWWWWWWWWWWWWWWWWWWWWWWWWWWWWWWWWWWWW
