WWWWWWWWWWWWWWWWWWWWWWWWWWWWWWWWWWWWWWWWWWWWWWWWWWWWWWWWWWWW
WK  D   D   D   D   D D   DBD D   D D   D   D   D   D   DEKW
WEW WDW WDW WDW W WDW WDWDWDW W WDW WDWDW W WDWDW W WDW W WW
W D   D   D   D   D     D       D     D   D   D   D   D    W
WDWDWDWDW WDW W WDWDW W W WDW W W WDW WDW WDWDWDWDWDWDW WDWW
W   D DDDDD DDD D D D D D D D D D D D D D D D D D D D D D  W
W W W WDW WDW W W W W WDW W WDW W WDW W W WDW W WDW WDWDWDWW
W   D   D   D   D   D D   D D D   D D   D   D   D   D   D  W
W W WDW WDW WDW W WDW WDWDWDW W WDW WDWDW W WDWDW W WDW W WW
W D   D   D   D   D     D       D     D   D   D   D   D    W
WDWDWDWDW WDW W WDWDW W W WDW W W WDW WDW WDWDWDWDWDWDW WDWW
W   D DDDDD DDD D D D D D D D D D D D D D D D D D D D D D  W
W W W WDW WDW W W W W WDW W WDW W WDW W W WDW W WDW WDWDWDWW
WB  D   D   D   D   D D   D D D   D D   D   D   D   D   D BW
W W WDW WDW WDW W WDW WDWDWDWJW WDW WDWDW W WDWDW W WDW W WW
W D   D   D   D   D     D       D     D   D   D   D   D    W
WDWDWDWDW WDW W WDWDW W W WDW W W WDW WDW WDWDWDWDWDWDW WDWW
W   D DDDDD DDD D D D D D D D D D D D D D D D D D D D D D  W
W W W WDW WDW W W W W WDW W WDW W WDW W W WDW W WDW WDWDWDWW
W W W WDW WDW W W W W WDW W WDW W WDW W W WDW W WDW WDWDWDWW
W   D   D   D   D   D D   D D D   D D   D   D   D   D   D  W
WEW WDW WDW WDW W WDW WDWDWDW W WDW WDWDW W WDWDW W WDW W WW
WKD   D   D   D   D     D    E  D     D   D   D   D   D  EKW
WDWDWDWDW WDW W WDWDW W W WDWKW W WDW WDW WDWDWDWDWDWDW WDWW
WWWWWWWWWWWWWWWWWWWWWWWWWWWWWWWWWWWWWWWWWWWWWWWWWWWWWWWWWWWW