WWWWWWWWWWWWWWWWWWWWWWWWWWWWWWWWWWWWWWWWWWWWWWWWWWWWWWWWWWWW
WJ D D D D D D D D D D D D D D D D D D D D D D D D D D D  WW
W DWDWDWDWDWDWDWDWDWDWDWDWDWDWDWDWDWDWDWDWDWDWDWDWDWDWDW D W
W D D D D D D D D D D D D D D D D D D D D D D D D D D D D  W
W DWDWDWDWDWDWDWDWDWDWDWDWDWDWDWDWDWDWDWDWDWDWDWDWDWDWDW D W
W D D D D D D D D D B D D D D D D D D D D D D D D D D D D KW
W DWDWDWDWDWDWDWDWDWDWDWDW  DWDWDWDWDWDWDWDWDWDWDWDWDWDW D W
W D D D D D D D D D D D D  E  D D D D D D D D D D D D D D  W
W DWDWDWDWDWDWDWDWDWDWDWDWDWDWDWDWDWDWDWDWDWDWDWDWDWDWDW D W
W D D D D D D D D D D D D D D D D D D D D D D D D D D D D  W
W DWDWDWDWDWDWDWDWDWDWDWDWDWDWDWDWDWDWDWDWDWDWDWDWDWDWDW D W
WEK D D D D D D D D D D D D D D D D D D D D D D D D D D D  W
W DWDWDWDWDWDWDWDWDWDWDWDWDWDWDWDWDWDWDWDWDWDWDWDWDWDWDW D W
W D D D D D D D D D D D D D D D D D D D D D D D D D D D D  W
W DWDWDWDWDWDWDWDWDWDWDWDWDWDWDWDWDWDWDWDWDWDWDWDWDWDWDW D W
W D D D D D D D D D D D D D D D D D D D D D D D D D D D B  W
W DWDWDWDWDWDWDWDWDWDWDWDWDWDWDWDWDWDWDWDWDWDWDWDWDWDWDW D W
W D D D D D D D D D D D D D D D D D D D D D D D D D D D D  W
WEDWDWDWDWDWDWDWDWDWDWDWDWDWDWDWDWDWDWDWDWDWDWDWDWDWDWDW D W
W D D D D D D D D D D D D D D D D D D D D D D D D D D D D  W
W DWDWDWDWDWDWDWDWDWDWDWDWDWDWDWDWDWDWDWDWDWDWDWDWDWDW D W W
W D D D D D D D D D D D D D D D D D D D D D D D D D D D D KW
W DWDWDWDWDWDWDWDWDWDWDWDWDWDWDWDWDWDWDWDWDWDWDWDWDWDWDW D W
WE D D D D D D D D D D D D D D D D D D D D D D D D D D D E W
WWWWWWWWWWWWWWWWWWWWWWWWWWWWWWWWWWWWWWWWWWWWWWWWWWWWWWWWWWWW
