WWWWWWWWWWWWWWWWWWWWWWWWWWWWWWWWWWWWWWWWWWWWWWWWWWWWWWWWWWWW
W                                                          W
W                                                          W
W    J     E                                               W
W                                                          W
W                                                          W
W                                                          W
W                 DDDDDDDDDDDDDDDDDDDDDDDDDDDD             W
W                                                          W
W                                                          W
W                                                          W
W                                                          W
W         K                     B                          W
W                                                          W
W             K               B                            W
W           B                                              W
W                                                          W
W                                                          W
W                                 K                        W
W                                                          W
W                                                          W
W                                                          W
W                                                          W
W                                                          W
WWWWWWWWWWWWWWWWWWWWWWWWWWWWWWWWWWWWWWWWWWWWWWWWWWWWWWWWWWWW
