WWWWWWWWWWWWWWWWWWWWWWWWWWWWWWWWWWWWWWWWWWWWWWWWWWWWWWWWWWWW
WK  D   D   D   D   D D   DBD D   D D   D   D   D   D   DEKW
WEW WDW WDW WDW W WDW WDWDWDW W WDW WDWDW W WDWDW W WDW W WW
W D   D   D   D   D     D       D     D   D   D   D   D    W
WDWDWDWDW WDW W WDWDW W W WDW W W WDW WDW WDWDWDWDWDWDW WDWW
W   D DDDDD DDD D D D D D D D D D D D D D D D D D D D D D  W
W W W WDW WDW W W W W WDW W WDW W WDW W W WDW W WDW WDWDWDWW
W   D   D   D   D   D D   D D D   D D   D   D   D   D   D  W
W W WDW WDW WDW W WDW WDWDWDW W WDW WDWDW W WDWDW W WDW W WW
W D   D   D   D   D     D    EK D     D   D   D   D   D    W
WDWDWDWDW WDW W WDWDW W W WDW W W WDW WDW WDWDWDWDWDWDW WDWW
W   D DDDDD DDD D D D D D D D D D D D D D D D D D D D D D  W
WDDDDDDDDDDDDDDDDDDDDDDDDDDDDDDDDDDDDDDDDDDDDDDDDDDDDDDDDDDW
WBDDDDDDDDDDDDDDDDDDDDDDDDDDDDDDDDDDDDDDDDDDDDDDDDDDDDDDDDBW
WDDDDDDDDDDDDDDDDDDDDDDDDDDDDDDDDDDDDDDDDDDDDDDDDDDDDDDDDDWW
WDDDDDDDDDDDDDDDDDDDDDDDDDDDDDDDDDDDDDDDDDDDDDDDDDDDDDDDDDDW
WDWDWDWDW WDW W WDWDW W W WDW W W WDW WDW WDWDWDWDWDWDW WDWW
W   D DDDDD DDD D D D D D D D D D D D D D D D D D D D D D  W
W W W WDW WDW W W W W WDW W WDW W WDW W W WDW W WDW WDWDWDWW
W   D   D   D   D   D D   D D D   D D   D   D   D   D   D  W
W W WDW WDW WDW W WDW WDWDWDW W WDW WDWDW W WDWDW W WDW W WW
W   D DDDDD DDD D D D D D D D D D D D D D D D D D D D D DEKW
WDWDWDWDW WDW W WDWDW W W WDWEW W WDW WDW WDWDWDWDWDWDW WDWW
W N W   W D   W   WD    W  D KD     W  D     DWD    W D    W
WWWWWWWWWWWWWWWWWWWWWWWWWWWWWWWWWWWWWWWWWWWWWWWWWWWWWWWWWWWW
