WWWWWWWWWWWWWWWWWWWWWWWWWWWWWWWWWWWWWWWWWWWWWWWWWWWWWWWWWWWW
WKE D DD DD DD  D  DD     D KED D D D D D D D D D D D D D  W
WDW WDWDW WDW W WDWDW W W WDW W W WDW WDW WDWDWDWDWDWDW WDWW
W   W   WKE       WD    W  D  D     W  D   EKDWD    W D    W
W   W   W   W   W   W W   W W W   W W   W   W   W   W   W  W
W W W W W W W W W W W W W W W W W W W W W W W W W W W W WW W
W   D DD DD DD  D  DD     D   D D D D D D D D D D D D D D  W
WDW WDWDW WDW W WDWDW W W WDW W W WDW WDW WDWDWDWDWDWDW WDWW
W   W   W D       WD    W  D  D     W  D   B DWD    W D    W
W   W   W   W   W   W W   W W W   W W   W   W   W   W   W  W
W W W W W W W W W W W W W W W W W W W W W W W W W W W W WW W
W   D DD DD DD  D  DD     D   D D D D D D D D D D D D D D BW
WDWDWDWDW WDW W WDWDW W W WDW W W WDW WDW WDWDWDWDWDWDW WDWW
W   W   W D       WD    W  D  D     W  D     DWD    W DE   W
W   W   W   W   W   W W   W W W   W W   W   W   W   W   W KW
W W W W W W W W W W W W W W W W W W W W W W W W W W W W WW W
W   D DD DD DD  D  DD     D   D D D D D D D D D D D D D D  W
WDWDWDWDW WDW W WDWDW W W WDW W W WDW WDW WDWDWDWDWDWDW WDWW
W   W   W D       WD    W  D  D     W  D     DWD    W D    W
W   W   W   W B W   W W   W W W   W W   W   W   W   W   W  W
W W W W W W W W W W W W W W W W W W W W W W W W W W W W WW W
W   D DD DD DD  D  DD     D   D D D D D D D D D D D D D D  W
WDWDWDWDW WDW W WDWDW W W WDW W W WDW WDW WDWDWDWDWDWDW WDWW
W   W   W D   W   WD    W  D JD     W  D     DWD    W D    W
WWWWWWWWWWWWWWWWWWWWWWWWWWWWWIWWWWWWWWWWWWWWWWWWWWWWWWWWWWWW
